----------------
--o.oo..o-------
--o---.o.o.o.---
--.---o.o.o.oo--
--ooo-------oo--
--.ooooT-S-ooo--
--o.--oo-o-ooo--
--oo.ooo-o--oo--
--ooo..o-o..o---
----------------