------------------
-----.......------
-----.......------
--oooo-----ooo----
--ooo-------oo----
--ooo-------oo----
--oSo--oooo.....--
--ooo--oooo.....--
-------oTo--..o.--
-------ooo--....--
------------------