------------------
--ooo.oooo.oooo---
--oo--------ooo---
--oo---------ooo--
--ooo---ooo--oSo--
--ooo...oTo--ooo--
--ooo--.ooo--o----
----o--.....oo----
----ooo..o...-----
-----oo......-----
-----ooo--oo------
------------------